#domain
hospital
#levelname
Box1
#colors
red: 0, A
#initial
+++++++++++
+         +
+ +++++++ +
+ +++++0+ +
+ +++++A+ +
+       + +
+++++++++ +
+         +
+ +++++++ +
+ +++++ + +
+ +++++ + +
+       + +
+++++++++++
#goal
+++++++++++
+         +
+ +++++++ +
+ +++++ + +
+ +++++ + +
+       + +
+++++++++ +
+         +
+ +++++++ +
+ +++++A+ +
+ +++++0+ +
+       + +
+++++++++++
#end
