#domain
hospital
#levelname
Box1
#colors
red: 0, A
#initial
+++++++++++
+         +
+ +++++++ +
+ +++++A+ +
+ +++++0+ +
+       + +
+++++++++ +
+         +
+ +++++++++
+ +++++ +++
+ +++++ +++
+       +++
+++++++++++
#goal
+++++++++++
+         +
+ +++++++ +
+ +++++ + +
+ +++++ + +
+       + +
+++++++++ +
+         +
+ +++++++++
+ +++++0+++
+ +++++A+++
+       +++
+++++++++++
#end
