#domain
hospital
#levelname
Box1
#colors
red: 0, A, B
#initial
+++++++++++
+ 0       +
+         +
+ A     B +
+++++++++++
#goal
+++++++++++
+  A    B +
+         +
+  0      +
+++++++++++
#end
