#domain
hospital
#levelname
Box1
#colors
red: 0, A
blue: 1, B
#initial
+++++++++++
+1        +
+         +
+++++B+++++
+         +
+         +
+0   A    +
+++++++++++
#goal
+++++++++++
+10      A+
+         +
+++++B+++++
+         +
+         +
+         +
+++++++++++
#end
