#domain
hospital
#levelname
Box1
#colors
red: 0, 4, 8, A, D, E, F, G, H, I, J, K, L, M, N, O, P, Q, R, S, Y
blue: 1, 6, B
green: 2, 3, 7, C
cyan: 5, Z
#initial
+++++++++++++++++++++++++++++++++++
+AAAAAAAAA1CAAB+3  A    A   A   AA+
+AAAAA     AAAA+     A    A   A   +
+AAAAAAAA AAAAA+AAAAAAAAAAAAAAAAA +
+AAAAAAAA      +CCCC              +
+AAAAAAAAAAAAA +BBBBBBBBBBBBBBBBBB+
+              +       R0 S       +
+ AAAAAAAAAAAAA+         R        +
+BAAAAAAAAAAAAA+             Y    +
+2AAAAAAAAAAAAA+                  +
+++++++++++++++++++++++++++++++++++
+4ZZ   5     G6+AZ 8  Z           +
+ZZZ         GE+IZ  Z Z           +
+ZZZ           +NZ  Z Z           +
+              +OZ  Z Z           +
+              +DZ  Z Z           +
+              +EZ  Z Z           +
+BB            + Z  Z Z           +
+7B            +    Z Z           +
+++++++++++++++++++++++++++++++++++
#goal
+++++++++++++++++++++++++++++++++++
+AAAAAAAAA BAA +CC                +
+AAAAA12   AAAA+CC                +
+AAAAAAAA AAAAA+                  +
+AAAAAAAA      +                  +
+AAAAAAAAAAAAA +                  +
+              +                  +
+ AAAAAAAAAAAAA+                  +
+CAAAAAAAAAAAAA+                  +
+ AAAAAAAAAAAAA+      S0RRY       +
+++++++++++++++++++++++++++++++++++
+              +                  +
+              +                  +
+              +     E            +
+     GG       +     D            +
+     EZ       +     O            +
+              +     N            +
+     75       +     I            +
+     46       +     A            +
+++++++++++++++++++++++++++++++++++
#end
