#domain
hospital
#levelname
Box1
#colors
red: 0, A
blue: 1, B
green: 2, C
#initial
+++++++++
+  BB  A+
+ 1     +
+       +
+CCCCCCC+
+       +
+       +
+0     A+
+++++++++
#goal
+++++++++
+       +
+       +
+  BB   +
+       +
+       +
+       +
+ A  0  +
+++++++++
#end
