#domain
hospital
#levelname
Box1
#colors
red: 0, A
#initial
+++++++++++
+         +
+ +++ +++ +
+ +++ +++ +
+ +++++++ +
+0        +
+++++++++++
#goal
+++++++++++
+        0+
+ +++ +++ +
+ +++ +++ +
+ +++++++ +
+         +
+++++++++++
#end
