#domain
hospital
#levelname
SAsoko3_06
#colors
blue: 0,1,A
#initial
++++++++
+0   A +
+      +
+      +
+      +
+      +
+1   A +
++++++++
#goal
++++++++
+     A+
+     A+
+     A+
+     A+
+     A+
+     A+
++++++++
#end
