#domain
hospital
#levelname
test3
#colors
red: 0
green: 1
#initial
+++++++++++++++++++++
+0                 1+
+                   +
+++++++++++++++++++++
#goal
+++++++++++++++++++++
+1                0 +
+                   +
+++++++++++++++++++++
#end
