#domain
hospital
#levelname
test5
#colors
red: 0
green: 1
blue: 2
#initial
+++++++++++++++++++++
+0     2           1+
+            +++++  +
+++++++++++++++++++++
#goal
+++++++++++++++++++++
+1                0 +
+            +++++2 +
+++++++++++++++++++++
#end
