#domain
hospital
#levelname
test2
#colors
red: 0
green: 1
#initial
++++++++++++++++++++++++++++
+                         0+
+1                         +
++++++++++++++++++++++++++++
#goal
++++++++++++++++++++++++++++
+0                         +
+                         1+
++++++++++++++++++++++++++++
#end
