#domain
hospital
#levelname
test5
#colors
red: 0
green: 1
blue: 2
#initial
+++++++++++++++++++++
+012                +
+       +++++++++++++
+++++++++++++++++++++
#goal
+++++++++++++++++++++
+                210+
+       +++++++++++++
+++++++++++++++++++++
#end
