#domain
hospital
#levelname
test5
#colors
red: 0
green: 1
blue: 2
purple: 3
cyan: 4
#initial
++++++++++++++
++++++  ++++++
+01        34+
++++++  ++++++
++++++++++++++
+2          ++
+           ++
++++++++++++++
#goal
++++++++++++++
++++++  ++++++
+43        01+
++++++  ++++++
++++++++++++++
+          2++
+           ++
++++++++++++++
#end
