#domain
hospital
#levelname
test5
#colors
red: 0
green: 1
#initial
+++++++++++++++++++++
+01                 +
+            ++++++++
+++++++++++++++++++++
#goal
+++++++++++++++++++++
+                 10+
+            ++++++++
+++++++++++++++++++++
#end
