#domain
hospital
#levelname
test5
#colors
green: 0,A
red: 1
#initial
++++++++++++++
++++++  ++++++
+0         A1+
++++++  ++++++
++++++++++++++
+           ++
+           ++
++++++++++++++
#goal
++++++++++++++
++++++  ++++++
+   0     1  +
++++++ A++++++
++++++++++++++
+           ++
+           ++
++++++++++++++
#end
