#domain
hospital
#levelname
MASubpoena
#colors
red: 0, A
blue: 1, 2, 3
#initial
++++++++++++++++++++++++++++++++++++++++++++++++++
+0                        123         A+         +
++++++++++++++++++ + ++ +++++++++++ ++++         +
+               ++ +++++++         +++++         +
++++++++++++++++++++++++++++++++++++++++++++++++++
#goal
++++++++++++++++++++++++++++++++++++++++++++++++++
+                                      +         +
++++++++++++++++++ + ++ +++++++++++A++++         +
+               ++ +++++++         +++++         +
++++++++++++++++++++++++++++++++++++++++++++++++++
#end